y=13 : ¡ò  ¡ò  ¡ò  ¡ò©¤¡ò©¤¡ò©¤¡ò©¤¡ò©¤¡ò©¤¡ò©¤¡ò©¤¡ò©¤¡ò  ¡ò  
       ©¦  ©¦  ©¦  ©¦          ©¦  ©¦  ©¦  ©¦              ©¦  
y=12 : ¡ò©¤¡ò  ¡ò  ¡ò©¤¡ò©¤¡ò  ¡ò  ¡ò  ¡ò  ¡ò©¤¡ò  ¡ò  ¡ò©¤¡ò  
       ©¦      ©¦  ©¦                  ©¦  ©¦      ©¦  ©¦      
y=11 : ¡ò  ¡ò  ¡ò  ¡ò©¤¡ò  ¡ò  ¡ò©¤¡ò  ¡ò  ¡ò©¤¡ò©¤¡ò©¤¡ò©¤¡ò  
       ©¦  ©¦  ©¦  ©¦      ©¦  ©¦  ©¦      ©¦              ©¦  
y=10 : ¡ò  ¡ò©¤¡ò©¤¡ò©¤¡ò©¤¡ò©¤¡ò  ¡ò©¤¡ò  ¡ò©¤¡ò©¤¡ò©¤¡ò  ¡ñ©¤
       ©¦  ©¦                  ©¦          ©¦              ©¦  
y=9  : ¡ò©¤¡ò©¤¡ò©¤¡ò  ¡ò©¤¡ò  ¡ò©¤¡ò©¤¡ò  ¡ò©¤¡ò©¤¡ò©¤¡ò  ¡ò  
       ©¦              ©¦      ©¦  ©¦  ©¦  ©¦      ©¦          
y=8  : ¡ò©¤¡ò  ¡ò©¤¡ò  ¡ò©¤¡ò  ¡ò  ¡ò  ¡ò  ¡ò©¤¡ò  ¡ò©¤¡ò©¤¡ò  
       ©¦      ©¦      ©¦      ©¦          ©¦      ©¦      ©¦  
y=7  : ¡ñ  ¡ò©¤¡ò©¤¡ò©¤¡ò  ¡ò  ¡ò©¤¡ò©¤¡ò  ¡ò©¤¡ò  ¡ò©¤¡ò  ¡ò  
       ©¦  ©¦          ©¦  ©¦      ©¦      ©¦      ©¦          
y=6  : ¡ò©¤¡ò©¤¡ò©¤¡ò  ¡ò©¤¡ò©¤¡ò  ¡ò  ¡ò©¤¡ò  ¡ò  ¡ò  ¡ò©¤¡ò  
       ©¦      ©¦  ©¦  ©¦          ©¦      ©¦  ©¦      ©¦      
y=5  : ¡ò©¤¡ò  ¡ò  ¡ò  ¡ò©¤¡ò©¤¡ò  ¡ò  ¡ò©¤¡ò©¤¡ò©¤¡ò  ¡ò©¤¡ò  
       ©¦                  ©¦                          ©¦      
y=4  : ¡ò©¤¡ò©¤¡ò©¤¡ò©¤¡ò  ¡ò©¤¡ò  ¡ò  ¡ò  ¡ò  ¡ò©¤¡ò©¤¡ò©¤¡ò  
       ©¦  ©¦  ©¦                  ©¦  ©¦  ©¦      ©¦          
y=3  : ¡ò  ¡ò  ¡ò©¤¡ò©¤¡ò©¤¡ò©¤¡ò©¤¡ò  ¡ò  ¡ò  ¡ò  ¡ò©¤¡ò  ¡ò  
       ©¦  ©¦  ©¦  ©¦  ©¦  ©¦  ©¦      ©¦  ©¦  ©¦  ©¦      ©¦  
y=2  : ¡ò  ¡ò  ¡ò  ¡ò  ¡ò  ¡ò  ¡ò©¤¡ò  ¡ò©¤¡ò©¤¡ò©¤¡ò©¤¡ò©¤¡ò  
       ©¦  ©¦          ©¦  ©¦  ©¦      ©¦                  ©¦  
y=1  : ¡ò  ¡ò©¤¡ò  ¡ò©¤¡ò  ¡ò  ¡ò©¤¡ò©¤¡ò©¤¡ò©¤¡ò©¤¡ò©¤¡ò  ¡ò  
       ©¦          ©¦  ©¦  ©¦  ©¦  ©¦      ©¦      ©¦          
y=0  : ¡ò©¤¡ò©¤¡ò  ¡ò  ¡ò  ¡ò  ¡ò  ¡ò©¤¡ò  ¡ò©¤¡ò  ¡ò©¤¡ò©¤¡ò  
                                                               
