y=2  : ¡ò  ¡ñ©¤¡ò  
       ©¦  ©¦  ©¦  
y=1  : ¡ò©¤¡ò  ¡ò  
       ©¦  ©¦  ©¦  
y=0  : ¡ñ  ¡ò  ¡ò  
       ©¦          

Floor 0
 ------------------------------
