y=2  : ¡ò©¤¡ñ  ¡ò  
       ©¦  ©¦  ©¦  
y=1  : ¡ò  ¡ò©¤¡ò  
       ©¦  ©¦  ©¦  
y=0  : ¡ò  ¡ò  ¡ñ  
               ©¦  

Floor 0
 ------------------------------
